##########
#P       #
# B  .   #
#   ###  #
# X   . L#
#  K  .  #
#   ###  #
##########