############
#P    C    #
#  X(10) . #
#          #
#  B     . #
############