##############
#P           #
# X(15)      #
#  K I IY    #
#LLLLLLLLLLLL#
#            #
#           .#
##############