##############
#P          .#
# ####  #### #
# #  B  B  # #
# # IIIIII # #
# # I    I # #
# # I XK I #L#
# # I    I # #
# # IIIIII # #
# #  .  .  # #
# ####  #### #
##############