  #######
###     #
#P# B   #
# #   B #
#       #
#  #  C #
#  #    # 
#  #    # 
#  #    # 
#  # .  #
# B# .  #
#  # .  #
#########  
