############
#P    C    #
#  X     . #
#          #
#  B     . #
############