   #####
   #   #  
####B  #    
#.. B  #  
#..B  ##  
#..# B#  
# .#B ##   
#### B #  
  # B  #
  #  P #  
  ######  