##########
#P       #
#  B   . #
#        #
#  B   . #
##########