 #####
 #   ###
# B#   #
# ..B. #
#  BB ##
### #.#
  #  P#
  #####