
############
#     #    #
#  B  #  . #
#     #    #
# P B      #
#     # B  #
#  .  #  . #
############