
 ######
 #    ##
##.##B #
# ..B  #
#  #X(9)#
#  P ###
######