##############
#P           #
#  K    L    #
#  IIIIIIIIII#
#       B  . #
#          . #
##############