##########
#P K Y . #
#   L B  #
#        #
##########

