################
#P    #        #
# BB  # IIIIII #
# ### # I    I #
#  X  # I CC I #
# ### # I    I #
#     # IIIIII #
# L   #    X   #
##### ####  ####
#  K  #  .  .  #
#  .  #  .  .  #
#     #  X     #
#     ####     #
################